AA::"ACOUSTICS"::ACOUSTICS
AF::"AGRICULTURAL-ECONOMICS-%26-POLICY"::AGRICULTURAL ECONOMICS & POLICY
AE::"AGRICULTURAL-ENGINEERING"::AGRICULTURAL ENGINEERING
AD::"AGRICULTURE%2C-DAIRY-%26-ANIMAL-SCIENCE"::AGRICULTURE, DAIRY & ANIMAL SCIENCE
AH::"AGRICULTURE%2C-MULTIDISCIPLINARY"::AGRICULTURE, MULTIDISCIPLINARY
AM::"AGRONOMY"::AGRONOMY
AQ::"ALLERGY"::ALLERGY
AY::"ANATOMY-%26-MORPHOLOGY"::ANATOMY & MORPHOLOGY
AZ::"ANDROLOGY"::ANDROLOGY
BA::"ANESTHESIOLOGY"::ANESTHESIOLOGY
BF::"ANTHROPOLOGY"::ANTHROPOLOGY
BM::"AREA-STUDIES"::AREA STUDIES
BU::"ASTRONOMY-%26-ASTROPHYSICS"::ASTRONOMY & ASTROPHYSICS
CL::"AUDIOLOGY-%26-SPEECH-LANGUAGE-PATHOLOGY"::AUDIOLOGY & SPEECH-LANGUAGE PATHOLOGY
AC::"AUTOMATION-%26-CONTROL-SYSTEMS"::AUTOMATION & CONTROL SYSTEMS
CN::"BEHAVIORAL-SCIENCES"::BEHAVIORAL SCIENCES
CO::"BIOCHEMICAL-RESEARCH-METHODS"::BIOCHEMICAL RESEARCH METHODS
CQ::"BIOCHEMISTRY-%26-MOLECULAR-BIOLOGY"::BIOCHEMISTRY & MOLECULAR BIOLOGY
BD::"BIODIVERSITY-CONSERVATION"::BIODIVERSITY CONSERVATION
CU::"BIOLOGY"::BIOLOGY
DA::"BIOPHYSICS"::BIOPHYSICS
DB::"BIOTECHNOLOGY-%26-APPLIED-MICROBIOLOGY"::BIOTECHNOLOGY & APPLIED MICROBIOLOGY
DI::"BUSINESS"::BUSINESS
DK::"BUSINESS%2C-FINANCE"::BUSINESS, FINANCE
DQ::"CARDIAC-%26-CARDIOVASCULAR-SYSTEMS"::CARDIAC & CARDIOVASCULAR SYSTEMS
CT::"CELL-%26-TISSUE-ENGINEERING"::CELL & TISSUE ENGINEERING
DR::"CELL-BIOLOGY"::CELL BIOLOGY
EA::"CHEMISTRY%2C-ANALYTICAL"::CHEMISTRY, ANALYTICAL
DW::"CHEMISTRY%2C-APPLIED"::CHEMISTRY, APPLIED
EC::"CHEMISTRY%2C-INORGANIC-%26-NUCLEAR"::CHEMISTRY, INORGANIC & NUCLEAR
DX::"CHEMISTRY%2C-MEDICINAL"::CHEMISTRY, MEDICINAL
DY::"CHEMISTRY%2C-MULTIDISCIPLINARY"::CHEMISTRY, MULTIDISCIPLINARY
EE::"CHEMISTRY%2C-ORGANIC"::CHEMISTRY, ORGANIC
EI::"CHEMISTRY%2C-PHYSICAL"::CHEMISTRY, PHYSICAL
RT::"CLINICAL-NEUROLOGY"::CLINICAL NEUROLOGY
EU::"COMMUNICATION"::COMMUNICATION
EP::"COMPUTER-SCIENCE%2C-ARTIFICIAL-INTELLIGENCE"::COMPUTER SCIENCE, ARTIFICIAL INTELLIGENCE
ER::"COMPUTER-SCIENCE%2C-CYBERNETICS"::COMPUTER SCIENCE, CYBERNETICS
ES::"COMPUTER-SCIENCE%2C-HARDWARE-%26-ARCHITECTURE"::COMPUTER SCIENCE, HARDWARE & ARCHITECTURE
ET::"COMPUTER-SCIENCE%2C-INFORMATION-SYSTEMS"::COMPUTER SCIENCE, INFORMATION SYSTEMS
EV::"COMPUTER-SCIENCE%2C-INTERDISCIPLINARY-APPLICATIONS"::COMPUTER SCIENCE, INTERDISCIPLINARY APPLICATIONS
EW::"COMPUTER-SCIENCE%2C-SOFTWARE-ENGINEERING"::COMPUTER SCIENCE, SOFTWARE ENGINEERING
EX::"COMPUTER-SCIENCE%2C-THEORY-%26-METHODS"::COMPUTER SCIENCE, THEORY & METHODS
FA::"CONSTRUCTION-%26-BUILDING-TECHNOLOGY"::CONSTRUCTION & BUILDING TECHNOLOGY
FE::"CRIMINOLOGY-%26-PENOLOGY"::CRIMINOLOGY & PENOLOGY
DS::"CRITICAL-CARE-MEDICINE"::CRITICAL CARE MEDICINE
FI::"CRYSTALLOGRAPHY"::CRYSTALLOGRAPHY
EN::"CULTURAL-STUDIES"::CULTURAL STUDIES
FU::"DEMOGRAPHY"::DEMOGRAPHY
FY::"DENTISTRY%2C-ORAL-SURGERY-%26-MEDICINE"::DENTISTRY, ORAL SURGERY & MEDICINE
GA::"DERMATOLOGY"::DERMATOLOGY
HY::"DEVELOPMENTAL-BIOLOGY"::DEVELOPMENTAL BIOLOGY
GU::"ECOLOGY"::ECOLOGY
GY::"ECONOMICS"::ECONOMICS
HA::"EDUCATION-%26-EDUCATIONAL-RESEARCH"::EDUCATION & EDUCATIONAL RESEARCH
HB::"EDUCATION%2C-SCIENTIFIC-DISCIPLINES"::EDUCATION, SCIENTIFIC DISCIPLINES
HE::"EDUCATION%2C-SPECIAL"::EDUCATION, SPECIAL
HQ::"ELECTROCHEMISTRY"::ELECTROCHEMISTRY
FF::"EMERGENCY-MEDICINE"::EMERGENCY MEDICINE
IA::"ENDOCRINOLOGY-%26-METABOLISM"::ENDOCRINOLOGY & METABOLISM
ID::"ENERGY-%26-FUELS"::ENERGY & FUELS
AI::"ENGINEERING%2C-AEROSPACE"::ENGINEERING, AEROSPACE
IG::"ENGINEERING%2C-BIOMEDICAL"::ENGINEERING, BIOMEDICAL
II::"ENGINEERING%2C-CHEMICAL"::ENGINEERING, CHEMICAL
IM::"ENGINEERING%2C-CIVIL"::ENGINEERING, CIVIL
IQ::"ENGINEERING%2C-ELECTRICAL-%26-ELECTRONIC"::ENGINEERING, ELECTRICAL & ELECTRONIC
IH::"ENGINEERING%2C-ENVIRONMENTAL"::ENGINEERING, ENVIRONMENTAL
IX::"ENGINEERING%2C-GEOLOGICAL"::ENGINEERING, GEOLOGICAL
IJ::"ENGINEERING%2C-INDUSTRIAL"::ENGINEERING, INDUSTRIAL
IK::"ENGINEERING%2C-MANUFACTURING"::ENGINEERING, MANUFACTURING
IL::"ENGINEERING%2C-MARINE"::ENGINEERING, MARINE
IU::"ENGINEERING%2C-MECHANICAL"::ENGINEERING, MECHANICAL
IF::"ENGINEERING%2C-MULTIDISCIPLINARY"::ENGINEERING, MULTIDISCIPLINARY
IO::"ENGINEERING%2C-OCEAN"::ENGINEERING, OCEAN
IP::"ENGINEERING%2C-PETROLEUM"::ENGINEERING, PETROLEUM
IY::"ENTOMOLOGY"::ENTOMOLOGY
JA::"ENVIRONMENTAL-SCIENCES"::ENVIRONMENTAL SCIENCES
JB::"ENVIRONMENTAL-STUDIES"::ENVIRONMENTAL STUDIES
JI::"ERGONOMICS"::ERGONOMICS
HF::"ETHICS"::ETHICS
JM::"ETHNIC-STUDIES"::ETHNIC STUDIES
HT::"EVOLUTIONARY-BIOLOGY"::EVOLUTIONARY BIOLOGY
JO::"FAMILY-STUDIES"::FAMILY STUDIES
JU::"FISHERIES"::FISHERIES
JY::"FOOD-SCIENCE-%26-TECHNOLOGY"::FOOD SCIENCE & TECHNOLOGY
KA::"FORESTRY"::FORESTRY
KI::"GASTROENTEROLOGY-%26-HEPATOLOGY"::GASTROENTEROLOGY & HEPATOLOGY
KM::"GENETICS-%26-HEREDITY"::GENETICS & HEREDITY
GC::"GEOCHEMISTRY-%26-GEOPHYSICS"::GEOCHEMISTRY & GEOPHYSICS
KU::"GEOGRAPHY"::GEOGRAPHY
KV::"GEOGRAPHY%2C-PHYSICAL"::GEOGRAPHY, PHYSICAL
KY::"GEOLOGY"::GEOLOGY
LE::"GEOSCIENCES%2C-MULTIDISCIPLINARY"::GEOSCIENCES, MULTIDISCIPLINARY
LI::"GERIATRICS-%26-GERONTOLOGY"::GERIATRICS & GERONTOLOGY
LJ::"GERONTOLOGY"::GERONTOLOGY
GS::"GREEN-%26-SUSTAINABLE-SCIENCE-%26-TECHNOLOGY"::GREEN & SUSTAINABLE SCIENCE & TECHNOLOGY
HL::"HEALTH-CARE-SCIENCES-%26-SERVICES"::HEALTH CARE SCIENCES & SERVICES
LQ::"HEALTH-POLICY-%26-SERVICES"::HEALTH POLICY & SERVICES
MA::"HEMATOLOGY"::HEMATOLOGY
MM::"HISTORY"::HISTORY
MQ::"HISTORY-%26-PHILOSOPHY-OF-SCIENCE"::HISTORY & PHILOSOPHY OF SCIENCE
MR::"HISTORY-OF-SOCIAL-SCIENCES"::HISTORY OF SOCIAL SCIENCES
MU::"HORTICULTURE"::HORTICULTURE
MW::"HOSPITALITY%2C-LEISURE%2C-SPORT-%26-TOURISM"::HOSPITALITY, LEISURE, SPORT & TOURISM
UE::"IMAGING-SCIENCE-%26-PHOTOGRAPHIC-TECHNOLOGY"::IMAGING SCIENCE & PHOTOGRAPHIC TECHNOLOGY
NI::"IMMUNOLOGY"::IMMUNOLOGY
NM::"INDUSTRIAL-RELATIONS-%26-LABOR"::INDUSTRIAL RELATIONS & LABOR
NN::"INFECTIOUS-DISEASES"::INFECTIOUS DISEASES
NU::"INFORMATION-SCIENCE-%26-LIBRARY-SCIENCE"::INFORMATION SCIENCE & LIBRARY SCIENCE
OA::"INSTRUMENTS-%26-INSTRUMENTATION"::INSTRUMENTS & INSTRUMENTATION
OI::"INTEGRATIVE-%26-COMPLEMENTARY-MEDICINE"::INTEGRATIVE & COMPLEMENTARY MEDICINE
OE::"INTERNATIONAL-RELATIONS"::INTERNATIONAL RELATIONS
OM::"LAW"::LAW
OU::"LIMNOLOGY"::LIMNOLOGY
OT::"LINGUISTICS"::LINGUISTICS
QL::"LOGIC"::LOGIC
PC::"MANAGEMENT"::MANAGEMENT
PI::"MARINE-%26-FRESHWATER-BIOLOGY"::MARINE & FRESHWATER BIOLOGY
QE::"MATERIALS-SCIENCE%2C-BIOMATERIALS"::MATERIALS SCIENCE, BIOMATERIALS
PK::"MATERIALS-SCIENCE%2C-CERAMICS"::MATERIALS SCIENCE, CERAMICS
QF::"MATERIALS-SCIENCE%2C-CHARACTERIZATION-%26-TESTING"::MATERIALS SCIENCE, CHARACTERIZATION & TESTING
QG::"MATERIALS-SCIENCE%2C-COATINGS-%26-FILMS"::MATERIALS SCIENCE, COATINGS & FILMS
QH::"MATERIALS-SCIENCE%2C-COMPOSITES"::MATERIALS SCIENCE, COMPOSITES
PM::"MATERIALS-SCIENCE%2C-MULTIDISCIPLINARY"::MATERIALS SCIENCE, MULTIDISCIPLINARY
PJ::"MATERIALS-SCIENCE%2C-PAPER-%26-WOOD"::MATERIALS SCIENCE, PAPER & WOOD
QJ::"MATERIALS-SCIENCE%2C-TEXTILES"::MATERIALS SCIENCE, TEXTILES
MC::"MATHEMATICAL-%26-COMPUTATIONAL-BIOLOGY"::MATHEMATICAL & COMPUTATIONAL BIOLOGY
PQ::"MATHEMATICS"::MATHEMATICS
PN::"MATHEMATICS%2C-APPLIED"::MATHEMATICS, APPLIED
PO::"MATHEMATICS%2C-INTERDISCIPLINARY-APPLICATIONS"::MATHEMATICS, INTERDISCIPLINARY APPLICATIONS
PU::"MECHANICS"::MECHANICS
OO::"MEDICAL-ETHICS"::MEDICAL ETHICS
PT::"MEDICAL-INFORMATICS"::MEDICAL INFORMATICS
PW::"MEDICAL-LABORATORY-TECHNOLOGY"::MEDICAL LABORATORY TECHNOLOGY
PY::"MEDICINE%2C-GENERAL-%26-INTERNAL"::MEDICINE, GENERAL & INTERNAL
OP::"MEDICINE%2C-LEGAL"::MEDICINE, LEGAL
QA::"MEDICINE%2C-RESEARCH-%26-EXPERIMENTAL"::MEDICINE, RESEARCH & EXPERIMENTAL
PZ::"METALLURGY-%26-METALLURGICAL-ENGINEERING"::METALLURGY & METALLURGICAL ENGINEERING
QQ::"METEOROLOGY-%26-ATMOSPHERIC-SCIENCES"::METEOROLOGY & ATMOSPHERIC SCIENCES
QU::"MICROBIOLOGY"::MICROBIOLOGY
RA::"MICROSCOPY"::MICROSCOPY
RE::"MINERALOGY"::MINERALOGY
ZQ::"MINING-%26-MINERAL-PROCESSING"::MINING & MINERAL PROCESSING
RO::"MULTIDISCIPLINARY-SCIENCES"::MULTIDISCIPLINARY SCIENCES
RQ::"MYCOLOGY"::MYCOLOGY
NS::"NANOSCIENCE-%26-NANOTECHNOLOGY"::NANOSCIENCE & NANOTECHNOLOGY
RX::"NEUROIMAGING"::NEUROIMAGING
RU::"NEUROSCIENCES"::NEUROSCIENCES
RY::"NUCLEAR-SCIENCE-%26-TECHNOLOGY"::NUCLEAR SCIENCE & TECHNOLOGY
RZ::"NURSING"::NURSING
SA::"NUTRITION-%26-DIETETICS"::NUTRITION & DIETETICS
SD::"OBSTETRICS-%26-GYNECOLOGY"::OBSTETRICS & GYNECOLOGY
SI::"OCEANOGRAPHY"::OCEANOGRAPHY
DM::"ONCOLOGY"::ONCOLOGY
PE::"OPERATIONS-RESEARCH-%26-MANAGEMENT-SCIENCE"::OPERATIONS RESEARCH & MANAGEMENT SCIENCE
SU::"OPHTHALMOLOGY"::OPHTHALMOLOGY
SY::"OPTICS"::OPTICS
TA::"ORNITHOLOGY"::ORNITHOLOGY
TC::"ORTHOPEDICS"::ORTHOPEDICS
TD::"OTORHINOLARYNGOLOGY"::OTORHINOLARYNGOLOGY
TE::"PALEONTOLOGY"::PALEONTOLOGY
TI::"PARASITOLOGY"::PARASITOLOGY
TM::"PATHOLOGY"::PATHOLOGY
TQ::"PEDIATRICS"::PEDIATRICS
ZD::"PERIPHERAL-VASCULAR-DISEASE"::PERIPHERAL VASCULAR DISEASE
TU::"PHARMACOLOGY-%26-PHARMACY"::PHARMACOLOGY & PHARMACY
UB::"PHYSICS%2C-APPLIED"::PHYSICS, APPLIED
UH::"PHYSICS%2C-ATOMIC%2C-MOLECULAR-%26-CHEMICAL"::PHYSICS, ATOMIC, MOLECULAR & CHEMICAL
UK::"PHYSICS%2C-CONDENSED-MATTER"::PHYSICS, CONDENSED MATTER
UF::"PHYSICS%2C-FLUIDS-%26-PLASMAS"::PHYSICS, FLUIDS & PLASMAS
UR::"PHYSICS%2C-MATHEMATICAL"::PHYSICS, MATHEMATICAL
UI::"PHYSICS%2C-MULTIDISCIPLINARY"::PHYSICS, MULTIDISCIPLINARY
UN::"PHYSICS%2C-NUCLEAR"::PHYSICS, NUCLEAR
UP::"PHYSICS%2C-PARTICLES-%26-FIELDS"::PHYSICS, PARTICLES & FIELDS
UM::"PHYSIOLOGY"::PHYSIOLOGY
UQ::"PLANNING-%26-DEVELOPMENT"::PLANNING & DEVELOPMENT
DE::"PLANT-SCIENCES"::PLANT SCIENCES
UU::"POLITICAL-SCIENCE"::POLITICAL SCIENCE
UY::"POLYMER-SCIENCE"::POLYMER SCIENCE
ML::"PRIMARY-HEALTH-CARE"::PRIMARY HEALTH CARE
VE::"PSYCHIATRY"::PSYCHIATRY
VI::"PSYCHOLOGY"::PSYCHOLOGY
NQ::"PSYCHOLOGY%2C-APPLIED"::PSYCHOLOGY, APPLIED
BV::"PSYCHOLOGY%2C-BIOLOGICAL"::PSYCHOLOGY, BIOLOGICAL
EQ::"PSYCHOLOGY%2C-CLINICAL"::PSYCHOLOGY, CLINICAL
MY::"PSYCHOLOGY%2C-DEVELOPMENTAL"::PSYCHOLOGY, DEVELOPMENTAL
HI::"PSYCHOLOGY%2C-EDUCATIONAL"::PSYCHOLOGY, EDUCATIONAL
VX::"PSYCHOLOGY%2C-EXPERIMENTAL"::PSYCHOLOGY, EXPERIMENTAL
VS::"PSYCHOLOGY%2C-MATHEMATICAL"::PSYCHOLOGY, MATHEMATICAL
VJ::"PSYCHOLOGY%2C-MULTIDISCIPLINARY"::PSYCHOLOGY, MULTIDISCIPLINARY
VP::"PSYCHOLOGY%2C-PSYCHOANALYSIS"::PSYCHOLOGY, PSYCHOANALYSIS
WQ::"PSYCHOLOGY%2C-SOCIAL"::PSYCHOLOGY, SOCIAL
VM::"PUBLIC-ADMINISTRATION"::PUBLIC ADMINISTRATION
NE::"PUBLIC%2C-ENVIRONMENTAL-%26-OCCUPATIONAL-HEALTH"::PUBLIC, ENVIRONMENTAL & OCCUPATIONAL HEALTH
VY::"RADIOLOGY%2C-NUCLEAR-MEDICINE-%26-MEDICAL-IMAGING"::RADIOLOGY, NUCLEAR MEDICINE & MEDICAL IMAGING
WC::"REHABILITATION"::REHABILITATION
SR::"REMOTE-SENSING"::REMOTE SENSING
WF::"REPRODUCTIVE-BIOLOGY"::REPRODUCTIVE BIOLOGY
WE::"RESPIRATORY-SYSTEM"::RESPIRATORY SYSTEM
WH::"RHEUMATOLOGY"::RHEUMATOLOGY
RB::"ROBOTICS"::ROBOTICS
WM::"SOCIAL-ISSUES"::SOCIAL ISSUES
WV::"SOCIAL-SCIENCES%2C-BIOMEDICAL"::SOCIAL SCIENCES, BIOMEDICAL
WU::"SOCIAL-SCIENCES%2C-INTERDISCIPLINARY"::SOCIAL SCIENCES, INTERDISCIPLINARY
PS::"SOCIAL-SCIENCES%2C-MATHEMATICAL-METHODS"::SOCIAL SCIENCES, MATHEMATICAL METHODS
WY::"SOCIAL-WORK"::SOCIAL WORK
XA::"SOCIOLOGY"::SOCIOLOGY
XE::"SOIL-SCIENCE"::SOIL SCIENCE
XQ::"SPECTROSCOPY"::SPECTROSCOPY
XW::"SPORT-SCIENCES"::SPORT SCIENCES
XY::"STATISTICS-%26-PROBABILITY"::STATISTICS & PROBABILITY
GM::"SUBSTANCE-ABUSE"::SUBSTANCE ABUSE
YA::"SURGERY"::SURGERY
YE::"TELECOMMUNICATIONS"::TELECOMMUNICATIONS
DT::"THERMODYNAMICS"::THERMODYNAMICS
YO::"TOXICOLOGY"::TOXICOLOGY
YP::"TRANSPLANTATION"::TRANSPLANTATION
YQ::"TRANSPORTATION"::TRANSPORTATION
YR::"TRANSPORTATION-SCIENCE-%26-TECHNOLOGY"::TRANSPORTATION SCIENCE & TECHNOLOGY
YU::"TROPICAL-MEDICINE"::TROPICAL MEDICINE
YY::"URBAN-STUDIES"::URBAN STUDIES
ZA::"UROLOGY-%26-NEPHROLOGY"::UROLOGY & NEPHROLOGY
ZC::"VETERINARY-SCIENCES"::VETERINARY SCIENCES
ZE::"VIROLOGY"::VIROLOGY
ZR::"WATER-RESOURCES"::WATER RESOURCES
ZK::"WOMENS-STUDIES"::WOMENS STUDIES
ZM::"ZOOLOGY"::ZOOLOGY
